----------------------------------
XXXXXXXXXXXXXXXXXXXXXXXXXXXXXXXXXX
X--M--------------------------XXXX
X----XXXXXX-------XXX-XXX-----XXXX
X--------X--------X-----X------XXX
X------X----------X-----X------XXX
X--.-XXXXXX-------XXXXXXXX-----XXX
X--.-----------------------.---XXX
X--.-X---X---X----X----XX--.---XXX
X--.-XXXXX---X----X---X--X----XXXX
X----X---X---X----X--XXXXXX----XXX
X----X---X---XXXXXX-X------X---XXX
X----....----......-.......----XXX
X-----XXXXXX-------X---X---X---XXX
X-----X-..-X---..---X-X-X-X----XXX
X-----XX-XXX---..----X...X-----XXX
X-------...----..--------------XXX
XJ----------------------------JXXX
XXX--XXXXXXXXXXXXXXXX--XXXXXXXXXXX
X----...-------------...-------XXX
XGG-J-----C-------------J-----GXXX
XXXXXXXXXXXXXXXXXXXXXXXXXXXXXXXXXX
----------------------------------
----------------------------------