+-+-+-+-+-+-+-+
##########|###|
+-+-+-+ +#+#+#+
| |     |###|#|
+ + +-+-+-+-+#+
|   |     | |#|
+ +-+-+-+ + +#+
|         | |#|
+-+-+ +-+-+ +#+
|###|       |#|
+#+#+-+-+-+-+#+
|#|#####|    #|
+#+-+-+#+-+-+#+
|#####|#|#####|
+-+-+#+#+#+-+-+
|#####|###|###|
+#+-+-+-+-+#+#+
|#|    ###|#|#|
+#+-+-+#+#+#+#+
|#######|###|##
+-+-+-+-+-+-+-+